WWWFWWWW
WFFFFFFW
WFWWWWFW
WFFFFWWW
WWWWFFFW
WFFFFFFW
WFWWWWFW
WFFWFFFW
WWWWEWWW