WWWFWWW
WFFFFFW
WFWWWFW
WFWFFFW
WFWWWFW
WFFFWFW
WWWEWWW