WWWWWWWWWWWWWWWWWWWWWW
WFFFFFFFFSFFFFFFFFFWWW
WFWWWWWFWFWFWWWWWFFWWW
WFWFFFFFWFWFWFFFFFFWWW
WFWFWWWWWFWFWFWWWWWWWW
WFWFWFFFFFWFWFWFFFFFFW
WFWFWFWWWWWFWFWFWFWFFW
WFSFWFWFFFFFWFWFSFWFFW
WFWFWFWWWWWFWFWFWFWFFW
WFWFWFFFFFWFWFWFFFFFFW
WFWWWWWFWFWFWWWWWFFWWW
WFFFFFFFFFWFFFFFFFFWWW
WFWWWWWWWWWWWWWWWFWWWW
WFFFFFFFFFFFFFFFFSFWWW
WWWWWWWWWWWWWWWWWWWWWW