WWWFWWWW
WFFFFFFW
WFWWWWFW
WFFFFWFW
WFWWFWFW
WFFWFWFW
WWFWFWFW
WFFWFWFW
WWWWEWWW