WWWWWFWWWWW
WFFFWFFFFFW
WFWFWWWWWFW
WFWFWFFFFFW
WFWFFFWWWFW
WFWWWWWWWFW
WFWFFFFFFFW
WFWWWWWWWWW
WFFFFFFFFFW
WWWWEWWWWWW