WWWFWWW
WFFFWFW
WFWFWFW
WFWFFFW
WFWWWFW
WFWFFFW
WWWEWWW